{
    "id": "level-1",
    "name": "Level 1",
    "description": "Initial level",
    "world": [

"tttttttttttttttttttt000000000000000000000000000000",
"tttttttttttttttttt00000000000000000000000000000000",
"tttttttttkkjjjjtttt0000000000000000000000000000000",
"ttttttkkkkttt0000tttt00000000000000000000000000000",
"0tttttkttttttttttt00000000000000000000000000000000",
"000tttkttttttttt0t00000000000000000000000000000000",
"000000kt0t0ttttt0t00000000000000000000000000000000",
"000000k0000tttttttt0000000000000000000000000000000",
"000000k0000000000000000000000000000000000000000000",
"000000k0000000000000000000000000000000000000000000",
"000000kkkkkkkk0000000000000qhhhhhhhhhe000000000000",
"0000000000000k0000000000000v000000000v000000000000",
"0000000000000kkkkkkkkkkkkkkk000000000v000000000000",
"000000000000000000000000000v000000000v000000000000",
"000000000000000000000000000zhhhhhhhhhc000000000000",
"00000000000000000000000000000000000000000000000000",
"00000000000000000000000000000000000000000000000000",
"00000000000000000000000000000000000000000000000000",
"00000000000000000000000000000000000000000000000000",
"00000000000000000000000000000000000000000000000000",
"00000000000000000000000000000000000000000000000000",
"00000000000000000000000000000000000000000000000000",
"00000000000000000000000000000000000000000000000000",
"00000000000000000000000000000000000000000000000000",
"00000000000000000000000000000000000000000000000000",
"00000000000000000000000000000000000000000000000000",
"00000000000000000000000000000000000000000000000000",
"00000000000000000000000000000000000000000000000000",
"00000000000000000000000000000000000000000000000000",
"00000000000000000000000000000000000000000000000000",
"00000000000000000000000000000000000000000000000000",
"00000000000000000000000000000000000000000000000000",
"00000000000000000000000000000000000000000000000000",
"00000000000000000000000000000000000000000000000000",
"00000000000000000000000000000000000000000000000000"

    ]
}