{
    "id": "level-1",
    "name": "Level 1",
    "description": "Initial level",
    "world": [

"tttttttttttttttttttt000000000000000000000000000000",
"tttttttttttttttttt00000000000000000000000000000000",
"ttttttttt000000tttt0000000000000000000000000000000",
"ttttttt000ttt0000tttt00000000000000000000000000000",
"0ttttttttttttttttt00000000000000000000000000000000",
"000ttttttttttttt0t00000000000000000000000000000000",
"0000000t0t0ttttt0t00000000000000000000000000000000",
"00000000000tttttttt0000000000000000000000000000000",
"00000000000000000000000000000000000000000000000000",
"00000000000000000000000000000000000000000000000000",
"000000000000000000000000000qhhhhhhhhhe000000000000",
"000000000000000000000000000v000000000v000000000000",
"0000000000000000000000000000000000000v000000000000",
"000000000000000000000000000v000000000v000000000000",
"000000000000000000000000000zhhhhhhhhhc000000000000",
"00000000000000000000000000000000000000000000000000",
"00000000000000000000000000000000000000000000000000",
"00000000000000000000000000000000000000000000000000",
"00000000000000000000000000000000000000000000000000",
"00000000000000000000000000000000000000000000000000",
"00000000000000000000000000000000000000000000000000",
"00000000000000000000000000000000000000000000000000",
"00000000000000000000000000000000000000000000000000",
"00000000000000000000000000000000000000000000000000",
"00000000000000000000000000000000000000000000000000",
"00000000000000000000000000000000000000000000000000",
"00000000000000000000000000000000000000000000000000",
"00000000000000000000000000000000000000000000000000",
"00000000000000000000000000000000000000000000000000",
"00000000000000000000000000000000000000000000000000",
"00000000000000000000000000000000000000000000000000",
"00000000000000000000000000000000000000000000000000",
"00000000000000000000000000000000000000000000000000",
"00000000000000000000000000000000000000000000000000",
"00000000000000000000000000000000000000000000000000"

    ]
}